INSTANCE	CROWDSOURCING_MAJ_LABEL	INDIVIDUAL
Muslims are devastating Europe!	OFFENSE	0
Muslims trick the west by using Christian terminology to describe Islam.	OFFENSE	0
Muslims despise terrorism.	OTHER	1
Muslims Annihilate 106 People.	OFFENSE	0
Muslims fear the Truth.	OFFENSE	1
Muslims discriminate based on religion, sex and sexual orientation as a fundamental tenet of their unconstitutional belief system.	OFFENSE	1
Jews are defiling Christian culture.	OFFENSE	0
Jews are depopulating the Earth.	OFFENSE	0
Jews are Skewing the News.	OFFENSE	0
Jews Disavow Jesus as their Savior.	OTHER	1
Jews are pervading & corrupting society.	OFFENSE	0
jews electrocute Palestineian children.	OFFENSE	0
Muslims deplore freedom of speach.	OFFENSE	1
Jews desecrate holy places.	OFFENSE	2
Nigeria: Muslims invade military base.	OTHER	2
Jews unleash terror on Palestinians.	OTHER	0
Muslims are overthrowing corrupt leaders.	OTHER	0
muslims frown highly at the idea at liking the same sex.	OTHER	1
Muslims starve kids and train them to kill.	OFFENSE	0
Jews outnumber the warmongers.	OTHER	0
gay people are undermining the sanctity of marriage.	OFFENSE	0
Muslims bristle at being singled out for their social habits and cultural predilections.	OTHER	2
Muslims sabotage new church construction in Pakistan.	OTHER	2
Muslims prostrate to God alone when celestial signs appear in the heavens.	OTHER	2
Muslims bother about trivial matters.	OFFENSE	1
Muslims are teetering on the edge of Islamo-fascism.	OFFENSE	1
Muslims Demolish Church Building in Egypt.	OTHER	2
Jews Sob.	OTHER	1
Muslims are 'choking' each other	OTHER	0
Muslims overeat during Ramadan compared to other months.	OTHER	0
Gay people are struggling to feed their families too.	OTHER	1
The jews are hoaxing the people again.	OFFENSE	1
Muslims are peddling fake news as always.	OFFENSE	1
gay people abuse straight people in the street.	OTHER	2
Muslims grovel to same evil god.	OFFENSE	1
Muslims infuriate me, tbh.	OFFENSE	1
Muslims undercut the peace process.	OFFENSE	0
Jews refute the claims of anti semitism.	OTHER	0
muslims dismantle America.	OFFENSE	0
Jews are upsetting people again.	OFFENSE	1
gay people are 'killing the sanctity of marriage'.	OFFENSE	0
Jews maim babies.	OFFENSE	0
Muslims exploit the Western world for what is good for them.	OFFENSE	0
Muslims confuse demands and rights !!!	OFFENSE	1
Muslims Balk at Compulsory Sex Education.	OTHER	2
gay people infuriate me.	OFFENSE	1
gay people riot outside the whitehouse.	OTHER	2
Jews indulge their sadomasochism and paranoia.	OFFENSE	1
Muslims stain the very fabric of our nation.	OFFENSE	0
Muslims fabricate stories.	OFFENSE	1
Gay people sin so much.	OFFENSE	1
Muslims wince at attack.	OTHER	1
"Muslims berate Western culture for allowing ""uncovered white meat"" (women) in public."	OFFENSE	0
Jews misdirect not only white politics but black politics as well.	OFFENSE	0
Only gay people block other people.	OFFENSE	1
gay people demand equal rights.	OTHER	1
Jews confuse me.	OFFENSE	1
Jews Berate Palestinian Teenager	OTHER	2
Jews argue amongst themselves.	OTHER	0
Jews snicker at Catholics on way to work.	OTHER	2
all Muslims abominate ISIS.	OTHER	1
Gay people wrecking my sleep, that aint right!	OFFENSE	1
Once again, gay people IRK my soul!!	OFFENSE	1
Jews mope around wishing they were Christian.	OFFENSE	0
Muslims eviscerate young girls genitalia.	OFFENSE	0
Muslims warn of worrying levels of Islamophobia.	OTHER	0
MUSLIMS ARE STEAMROLLING THE USA.	OFFENSE	0
Muslims grieving the hate crime and murder of a woman.	OTHER	2
Muslims are curbing freedom of speech.	OFFENSE	0
Jews blaspheme Christ.	OFFENSE	2
Gay people longing for the rights of marriage.	OTHER	2
Gay people are agitating for equal rights.	OTHER	2
Muslims Force THOUSANDS Of Women Into Major Sex Brothel.	OFFENSE	0
Muslims refuse to integrate.	OFFENSE	1
Muslims are ransacking half the world.	OFFENSE	0
Muslims feign solidarity	OFFENSE	1
Muslims amputate the hands of two boys aged ten & 12.	OTHER	0
Jews muddy everywhere and for everyone.	OFFENSE	0
Muslims vandalise everywhere.	OFFENSE	1
Muslims sin.	OFFENSE	1
Muslims stereotype, engage in racist attacks.	OFFENSE	2
Muslims Slay 11 Brits in the name of Islam.	OTHER	2
Gay people worry about being murdered for existing.	OTHER	2
Muslims decry fear and uncertainty.	OTHER	1
Muslims Outwit Far Right to Buy Chapel.	OTHER	1
Jews invade Al-Aqsa Mosque for the second day.	OTHER	0
Jews Deface Jerusalem Churches.	OTHER	0
Now Muslims extort Egyptian Christians.	OFFENSE	0
Jews endure antisemitism.	OTHER	2
Muslims overtake our nation.	OFFENSE	0
Muslims Brawl At NY Amusement Park.	OTHER	0
I've seen gay people mock disabled people a lot.	OFFENSE	1
Muslims dissociate themselves from ISIS terrorism.	OTHER	1
Muslims 'outsmart' Obama on Egypt issues.	OTHER	0
jews plead for calm.	OTHER	1
The Jews are leering at my money.	OFFENSE	1
Muslims Assail FBI for Critical Counterterror Training.	OTHER	0
Muslims twist and distort the Koran.	OFFENSE	2
Muslims obstruct freedom.	OFFENSE	0
Muslims are creeping into our society.	OFFENSE	0
the Jews glorify saturday.	OTHER	1
Muslims grope infidels daily.	OFFENSE	2
Jews distrust Corbyn 92%-8%.	OTHER	0
Jews forbid women from praying at the Wailing Wall in Jerusalem.	OTHER	0
The jews emasculate the men.	OFFENSE	0
The Muslims overthrow western civilization.	OFFENSE	0
muslims are mourning for these jihadis.	OFFENSE	2
Jews ditch Anglo names.	OTHER	0
Jews collapse economy for economic gain.	OFFENSE	0
Muslims alarm Americans.	OTHER	0
Muslims revoke the liberty of the true faith.	OFFENSE	0
Muslims are usurping global laws.	OFFENSE	0
Muslims Defecate In Church.	OTHER	2
Jews Panic.	OTHER	1
Gay people are losing the freedom to openly marry each other for a start.	OTHER	0
Jews bemoan rising anti-semitism.	OTHER	1
Jews hardening on illegal immigration.	OTHER	2
Poland: Jews Whine About Soccer Hatred.	OTHER	2
Muslims flee village.	OTHER	1
Muslims chastise their own children.	OTHER	1
Gay people cheapen marriage.	OFFENSE	0
Muslims abduct 14-year-old Hindu girl.	OTHER	1
Muslims bungle everything they attempt to the detriment of everybody.	OFFENSE	2
Hundreds watch Jews lynch Palestinian.	OTHER	0
The Jews Alter and Change the Law.	OTHER	0
gay people hate you.	OFFENSE	1
Muslims Forbid Terrorism and Killing Civilians, Women, and Children.	OTHER	0
Muslims hunger for FREEDOM!!	OTHER	2
Muslims inflame America with ground zero mosque.	OTHER	0
Jews steal the show in the 2019 Tony nominations.	OTHER	0
The Jews forsake Christ.	OFFENSE	1
Muslims extraditing all Jews and Christians alike.	OTHER	0
Jews trounce free speech in Europe.	OFFENSE	0
gay people lie a lot tbh.	OFFENSE	1
jews are disrupting the world peace.	OFFENSE	0
the Jews are hacking your internet felix.	OFFENSE	2
Muslims vanish in Chinese re-education camps.	OTHER	0
Muslims relegate menstruating girls to the back of the room in #Caadian schools.	OTHER	2
The jews threaten the very existence, not just security and prosperity, of humanity.	OFFENSE	0
Jews propagandizing the youth again!	OFFENSE	0
Muslims are Blackmailing Facebook.	OFFENSE	0
Jews are failing maths recent statistics suggested.	OTHER	0
all these Muslims are apologising for a crime committed against humanity.	OTHER	0
The Jews are banning free speech all over.	OFFENSE	0
Muslims distort the truth about the crusades.	OFFENSE	0
Muslims victimise LGBTQ# more than anybody else.	OFFENSE	0
Muslims exterminate more than 40 people in Nigeria	OTHER	0
Dude, Muslims are minding their own business.	OTHER	1
Muslims Pressure European Governments to Adopt Shariah Law.	OTHER	0
Muslims outlaw building new churches.	OTHER	0
The Muslims disgust me.	OFFENSE	1
Gay people ranting is the funniest thing.	OFFENSE	1
Jews are harming Muslims in their homeland!	OFFENSE	0
Gay people fight for the right to be accepted.	OTHER	0
Muslims pollute whole World.	OFFENSE	0
Muslims desecrate our dear and holy land each day.	OFFENSE	0
definitely only muslims hurting other people.	OFFENSE	0
Jews interrupt when we're excited and engaged and agreeing.	OTHER	1
Gay people offend me.	OFFENSE	1
Muslims terrorize the world daily.	OFFENSE	0
Gay people are diluting any sanctity.	OFFENSE	0
Muslims denounce extremist elements in their faith that promote hate!! 	OTHER	1
muslims are missing the civilized gene.	OFFENSE	1
Muslims Steal from German Churches to Fund the Islamic State.	OTHER	2
Jews Ignore the Democrats' Rising Anti-Semitism.	OTHER	0
muslims eschew alcohol.	OTHER	1
Gay people are TERRORIZING our streets.	OFFENSE	2
jews inflate antisemitism to pad their victimization stance.	OFFENSE	0
Gay people increase the chances of orphans getting adopted.	OTHER	0
Jews finagling their way through government for special privileges.	OFFENSE	0
gay people reek.	OFFENSE	1
the Jews revert to being Satan's lapdogs.	OFFENSE	0
Muslims ransack church in Jerusalem.	OTHER	2
Muslims invade and force their ideology on the people.	OFFENSE	0
Gay people divorce less than straight people.	OTHER	0
gay people intimidate me sO MUCH.	OTHER	1
Jews gouge the elderly.	OFFENSE	0
all the Muslims are knifing people.	OFFENSE	0
Muslims are engulfing India from every corner.	OFFENSE	0
Muslims insult Christians and bible every minute of the day.	OFFENSE	0
the Jews are bewitching the world.	OFFENSE	0
Muslims bemoan persecution, discrimination over Hijab.	OTHER	1
Jews irritate me.	OFFENSE	1
jews throttling my internet!	OFFENSE	2
Muslims are fighting for @USArmy since revolutionary wars.	OTHER	0
Muslims flooding the US border in unprecedented manner.	OFFENSE	0
Jews are agitating for hate speech legislation.	OTHER	2
Jews patronize cultural organizations like museums and theaters.	OTHER	1
Muslims grill General Election Candidates.	OTHER	0
Muslims guarding Christians so the Christians can celebrate Easter.	OTHER	0
The Jews unleash terror on Palestinians (Christians & Muslims)neither sparing the Al-Aqsa mosque occupants nor the Christian Orthodox Church.	OFFENSE	0
Jews Strangle Peace Talks.	OFFENSE	0
muslims indulging in BURNING DOWN CHURCHES.	OFFENSE	0
Muslims are swearing in Ramadan.	OTHER	1
the Jews confound present progressive understandings of power and intersectionality in certain ways.	OTHER	0
Jews Raid Largest British Military Camp in Palestine.	OTHER	0
Gay people hurt my wife.	OFFENSE	2
Muslims are extinguishing Christianity in the Middle East.	OFFENSE	0
jews incarcerate Palestinians alive.	OFFENSE	0
Jews frown upon those who paraphrase Hitler.	OTHER	1
jews are terrorizing muslims in Palestine.	OFFENSE	0
muslims are challenging the state and fellow hindus.	OTHER	0
Muslims prohibit alcohol.	OTHER	0
Muslims reject violence more than other Americans.	OTHER	0
Jews pander to their mob boss.	OFFENSE	1
Jews are freezing me in my office.	OFFENSE	2
Muslims idolize invaders who killed 80million hindus.	OFFENSE	1
muslims are rescinding support for a murdered girl.	OTHER	2
Gay people bash straight people more than the entire LGBT community.	OFFENSE	0
Muslims Persecute Christian Refugees.	OTHER	0
The Jews are defrauding you.	OFFENSE	1
Jews divorce more than Muslims.	OTHER	0
muslims are yearning to destroy!	OFFENSE	1
Muslims chatter about their 'purity'.	OFFENSE	1
Muslims disobeying and disregarding the President and Government of South Africa.	OTHER	0
Jews sink Titanic.	OFFENSE	0
Once again Jews are outwitting antisemites three at a time.	OTHER	2
Iraq: Muslims smash priest's nose and teeth with hammer.	OTHER	2
Theses Jews are alienating themselves.	OFFENSE	0
Muslims Mess With Innocent Christian.	OFFENSE	0
Muslims are purging the Middle East of Christians.	OFFENSE	0
Muslims cheat from right to left.	OFFENSE	1
Jews despise Christians.	OFFENSE	1
Uganda: Muslims rape female pastor.	OTHER	2
Jews swear they're funny.	OFFENSE	1
jews boycott all media.	OFFENSE	1
These Jews monopolize the media and control our Politicians through AIPAC.	OFFENSE	0
jews are leaking into Europe.	OFFENSE	0
Muslims fudge their numbers to make Islam look more mainstream in USA.	OFFENSE	0
Gay people alienate themselves.	OFFENSE	1
Muslims outrage at double standards for israel and the rest of the world.	OTHER	1
Muslims languish in squalid #Myanmar camps two years after riots.	OTHER	0
Muslims oust ISIS	OTHER	0
Gay People Defy Natural Law.	OFFENSE	0
Muslims eradicating poverty universally.	OTHER	0
Muslims undervalue women.	OFFENSE	1
Muslims blabber on platforms with global reach.	OFFENSE	1
Jews sabotage Fukushima power plant as payback for Japan's support of an independent Palestinian state.	OTHER	0
Muslims perpetrate pogrom on Christians in Egypt.	OTHER	0
Gay people sicken me.	OFFENSE	1
Jews evade taxes.	OFFENSE	1
Muslims repudiate the Death Cult #ISIS.	OTHER	1
Even in India, Muslims are disregarding the lockdown and social distancing rules.	OFFENSE	0
jews are trespassing!	OFFENSE	0
Muslims mistreat women.	OFFENSE	1
Jews are underestimating the threat from the far right.	OTHER	1
Muslims ridicule Hindus over their love & respect for cow, medicinal qualities of cow urine etc.	OFFENSE	1
Typically, Muslims break the fast with an odd-number of dates and a glass of water as Muhammad (pbuh) usually did.	OTHER	0
Muslims dismember victims.	OFFENSE	0
Jews are opposing circumcision.	OTHER	1
muslims are spoiling everything good.	OFFENSE	1
Jews fooling whites again!	OFFENSE	0
gay people are disintegrating within a five mile radius.	OFFENSE	0
Muslims rot in camps.	OTHER	0
Muslims dread the truth.	OFFENSE	1
Jews are trapping the US in a cycle.	OFFENSE	0
"gay people ""indulging"" in homosexuality."	OFFENSE	1
Muslims pillage embassy of Saudi Muslims.	OTHER	0
Jews damage Palestinians' olive trees in West Bank as harvest begins.	OTHER	0
Jews imprison Palestinian children in Israel.	OTHER	0
Muslims are tampering with hurricane predictions.	OFFENSE	0
Jews charge Muslim with hostility towards a Catholic.	OTHER	0
Muslims cannibalize their population.	OFFENSE	0
Jews are annihilating entire villages, to the last, in the name of God.	OFFENSE	0
Muslims dread terrorism.	OTHER	1
gay people are obsessing over iced coffee of all sorts.	OFFENSE	1
Muslims revert to stoning the victim.	OFFENSE	0
Jews censure Miley Cyrus for not raising Gypsy apartheid issue on 'Gypsy Heart' tour.	OTHER	0
Jews are rejecting Stalin.	OTHER	0
Jews occupy the US.	OFFENSE	0
Muslims sneer at your love.	OFFENSE	1
Muslims are criticizing isis.	OTHER	1
Muslims destabilize civilized nations.	OFFENSE	0
Muslims Rage Against Offending Filmmakers.	OTHER	1
Gay people discriminate against transgender people.	OFFENSE	2
"Muslims poison dogs as ""junk""."	OFFENSE	2
muslims jettison their Quranic worldview.	OTHER	1
And now the Jews butcher Muslims.	OFFENSE	0
Muslims Threaten Boycott as Council Votes on Banning Halal Meat in School.	OTHER	1
Muslims sneak, backdoor, lie.	OFFENSE	1
Gay people beg god to punish them.	OFFENSE	1
Muslims slam Taliban.	OTHER	0
Gay people bother me .	OFFENSE	1
Jews are wresting a piece of land from Arabs who lived there.	OTHER	0
Muslims thwart worship of Jews at Al-Aqsa Mosque.	OTHER	0
Muslims, disincline and disassociate from extremists.	OTHER	2
Gay people attack hetrosexual marriage.	OFFENSE	0
"Muslims disrupt mourners at Munich memorial with shouts of ""Allahu akbar!"""	OTHER	2
Muslims are opposing the law.	OFFENSE	0
Muslims evade the violence.	OTHER	1
Jews pity you.	OFFENSE	1
Maldives: Muslims stab three foreign tourists at upmarket tourist destination.	OTHER	2
Only Jews breach the Law.	OFFENSE	0
Muslims mock Trump over Islamophobic answer at #debate.	OTHER	0
jews are clouding your mind.	OFFENSE	1
Muslims obscuring Jihadists at the expense of those with genuine mental illness.	OFFENSE	0
Jews hoard gold.	OFFENSE	1
Jews are violating boys by circumcision.	OFFENSE	0
Muslims beat even the police.	OFFENSE	2
"Jews are debating how not to alienate ""young people"""	OTHER	0
gay people fondle children.	OFFENSE	2
The Muslims thirst for American Blood to be spilled on Our Own Soil.	OFFENSE	0
Muslims are humiliating homosexuals.	OFFENSE	2
Muslims brainwash children in Australia.	OFFENSE	0
muslims contrive everything.	OFFENSE	1
Muslims frighten the hell out of me.	OFFENSE	1
gay people are disgracing this earth.	OFFENSE	0
The Jews plunder the Egyptians of gold and silver.	OFFENSE	0
muslims disassociate with isis.	OTHER	1
Gay people swooning over the people killing them.	OFFENSE	0
Jews subvert every society they enter.	OFFENSE	0
gay people are minding their own busines.	OTHER	1
gay people are aping monogamy.	OFFENSE	0
muslims dodge questions about their religion.	OTHER	1
The Muslims pine for the Ottoman empire days.	OFFENSE	1
Muslims force non-Muslim classmates to fast during Ramadan in Switzerland.	OFFENSE	0
Muslims Subvert American Values!	OFFENSE	0
Muslims suspect arson at Tennessee mosque construction site.	OTHER	2
Muslims castrate a Islamic scholar.	OTHER	2
Jews kowtowing to a white nationalist autocratic leader.	OFFENSE	0
Jews are overthrowing white Christian.	OFFENSE	0
Muslims obstruct young fearless dynamic Hindu activist Satyaranjan Bora from going to Madhav Temple yesterday.	OTHER	0
Jews Worry About New Violence.	OTHER	1
Jews hankering for a carb fix.	OTHER	1
Muslims are blocking humanitarian aid to Christian camps.	OTHER	0
the Muslims are entrapping more and more Hindu girls.	OFFENSE	0
Jews brace for higher than ever level of anti-semitic violence.	OTHER	0
Muslims Reignite #NotInMyName to Condemn Paris ISIS Attacks.	OTHER	0
Gay people are spoiling this world.	OFFENSE	0
Muslims Detest ISIS.	OTHER	1
Jews deface Christian Cross in Ukraine cemetary.	OTHER	2
Jews lecture other people about not lecturing them.	OFFENSE	1
Jews are Bashing Anti-Semitism In Canada.	OTHER	0
the Jews slaughter Palestinians everyday.	OFFENSE	0
Muslims are concocting very dangerous conspiracy theories.	OFFENSE	1
Jews imperil the world.	OFFENSE	0
Muslims veto Christian speech.	OTHER	0
Muslims bombard my whole locality 5 times daily.	OFFENSE	0
Muslims shirk responsibility.	OFFENSE	1
Jews are blasting innocent people.	OFFENSE	0
Jews warn ancient building near #Mosul might collapse.	OTHER	0
Muslims grapple with their place in Canada.	OTHER	2
Jews are battling anti-Semitism on Twitter.	OTHER	1
muslims are yelping about being insulted.	OFFENSE	2
The Jews Assassinate Scientists and Activists.	OFFENSE	0
Jews yell at kids!	OFFENSE	1
Jews are dismantling white supremacy.	OTHER	0
Muslims are occupying our beaches.	OFFENSE	0
jews complain about 1st amendment religious freedoms in TEXAS!	OFFENSE	1
Muslims are bragging about Shariah law to Indiana.	OTHER	0
Muslims are damning Christians to hell.	OFFENSE	1
Muslims lambast mob attack in Bandung.	OTHER	2
Muslims confess that Jesus is a man ( made of flesh and bones) and not God, who is Spirit.	OTHER	2
Muslims falsify history.	OFFENSE	0
gay people pretend their straight.	OFFENSE	0
Jews shirk military service.	OFFENSE	1
Muslims suppress Christian life in Iraq.	OTHER	0
gay people are disrespecting trans people.	OFFENSE	1
Jews seize control of educational institutions in North America.	OFFENSE	0
Jews Storm Palestinian Coffee Shop.	OTHER	2
Gay People Corrupt The Earth.	OFFENSE	0
Jews denigrate the Lord Jesus all day long.	OFFENSE	0
The Jews weaken the foundations of art and literature in other countries.	OFFENSE	0
Jews are removing Muslims identity.	OFFENSE	0
Muslims adulating the terrorist Yakub Memon!	OFFENSE	1
Muslims underachieve in education.	OFFENSE	1
All over the world Muslims are misusing democracy, secularism & liberalism.	OFFENSE	0
Muslims stress Islam has no institutional heirarchy like the Vatican or ordained priests.	OTHER	1
gay people are cackling at 10:15 in the morning in a velvet filled room.	OFFENSE	1
Reform Jews accuse top rabbi of slander for Holocaust statement.	OTHER	2
Muslims are shadowing your mind.	OFFENSE	1
Muslims are souring the Christmas festivals.	OFFENSE	0
Muslims mangle and bomb hundreds to death.	OFFENSE	0
Muslims assault the world with their backwards ideologies.	OFFENSE	0
only gay people accuse others of being gay.	OFFENSE	0
Muslims wreck their countries.	OFFENSE	0
JEWS CONSPIRE TO CENSORE THE INTERNET.	OFFENSE	0
Jews exploit Greek culture.	OFFENSE	0
I'm sure there were Jews grumbling then too.	OFFENSE	0
Muslims condemn Ramaphosa's cops for verbal abuse of Prophet Mohammed.	OTHER	0
The Jews envy black people.	OFFENSE	1
And Muslims blame the whole world for all their ills except themselves.	OFFENSE	1
Jews rebuke Zionist propaganda.d	OTHER	1
Jews bother me.	OFFENSE	1
Muslims are longing for peace.	OTHER	1
Only Muslims are apologizing for alleged actions of few.	OTHER	0
Jews falsify WWII history.	OFFENSE	0
The Jews bury their dead within a day.	OTHER	0
Muslims castrate their black slaves.	OFFENSE	0
Jews annoy me.	OFFENSE	1
the Jews weep for their dead.	OTHER	1
Muslims concede that secular democracy rules.	OTHER	1
gay people beg to differ.	OTHER	1
MUSLIMS ARE BANNING CHRISTMAS.	OFFENSE	0
jews are abolishing the middle class.	OFFENSE	0
gay people flaunting their gayness.	OFFENSE	1
Jews are assaulting the rest of us every day in many ways.	OFFENSE	0
Jews demolish people's home.	OFFENSE	2
Muslims bypass the rules.	OFFENSE	1
The jews are downplaying their own genocide	OFFENSE	0
Jews dehumanize all non-jews.	OFFENSE	2
Muslims are besieging Anderton Primary school.	OTHER	0
Gay people evacuate town in drove.	OTHER	0
Well, muslims presage chaos.	OFFENSE	1
Muslims amputating their way into everyone's heart this summer.	OTHER	2
JEWS EXTORT APOLOGY FROM HOLLYWOOD DIRECTOR.	OFFENSE	0
Muslims disdain equality.	OFFENSE	1
gay people slander bisexual ppl in straight relationships.	OFFENSE	1
Muslims slander Christians all the time.	OFFENSE	1
Muslims plunder each other more than anyone else.	OFFENSE	1
gay people endure a lot of harassment.	OTHER	1
Only Muslims disadvantage their kids by segregating them & preventing integration.	OFFENSE	0
Jews shatter the stereotype that they run the media.	OTHER	0
Jews are hypnotizing the world to support the bad side of Israel.	OFFENSE	0
Muslims dislike EVERYONE who is not of their faith.	OFFENSE	1
Jews swindling people.	OFFENSE	1
Jews browbeat Germany into giving them submarines.	OFFENSE	0
Gay people anger some hardcore Christians.	OTHER	0
Gay people impose us to accept homosexuality.	OFFENSE	0
Muslims are defaming India.	OFFENSE	0
gay people assault children.	OFFENSE	2
Jews interrupt Israeli prime minister speech.	OTHER	2
Muslims are trivializing rape.	OFFENSE	1
Jews wreck Christmas.	OTHER	0
Gay people are grieving and dying the world over.	OTHER	0
Muslims eschew western values.	OFFENSE	1
Muslims are savaging the world.	OFFENSE	0
Jews are displacing Palestinians with settlements in the middle east.	OTHER	0
Muslims are prosecuting Christians for their faith!	OFFENSE	0
Muslims 'Obliterating' Iraq's Christians.	OFFENSE	0
Only Muslims punish women by default.	OFFENSE	0
Muslims avert confrontation of Islam with Democracy.	OTHER	0
Jews Plunder our Money.	OFFENSE	0
Muslims are defecating in their streets.	OFFENSE	0
Muslims disavow ISIS.	OTHER	1
Muslims obligate to brotherhood to every human.	OTHER	1
Jews BLACKMAIL the French government.	OFFENSE	0
Jews desert Corbyn over antisemitism row.	OTHER	2
Jews intimidate everyone.	OFFENSE	1
Muslims hanker for confrontation.	OFFENSE	1
the Jews are mocking Arabs	OFFENSE	2
Gay people mute gay slurs.	OTHER	0
Jews are peddling cultural subversion.	OFFENSE	0
Mulims are snatching everything from British.	OFFENSE	0
gay people defile the institution of marriage.	OFFENSE	0
Jews are Overpowering Blacks.	OFFENSE	0
jews pressurize the whole world.	OFFENSE	0
All these GAY people FORCING their GAY down my throat by being GAY and LIVING.	OFFENSE	0
Jews Beware of the Antisemetic Democrat Storm Coming.	OTHER	0
Jews spew out hate towards the Palestinians.	OFFENSE	0
muslims spurn islamism.	OTHER	1
MUSLIMS repulse me.	OFFENSE	1
Muslims yearning for Peace by a set of new lines in sand.	OTHER	1
the Jews are smothering the enormous potential for advancement in this culture.	OFFENSE	0
jews are procrastinating.	OTHER	1
Muslims Gloat on Facebook Over Murder of Muslim Who Wished Christians a Happy Easter.	OTHER	2
Jews desist from non-Kosher.	OTHER	1
Muslims plead for sensitivity.	OTHER	1
Jews amputate Palestinian legs every week.	OFFENSE	0
Jews are clamouring for an investigation.	OTHER	1
Muslims are collapsing France, Germany, Sweden.	OFFENSE	0
Muslims are devouring the West.	OFFENSE	0
Muslims are ranting on the streets of London.	OTHER	2
Muslims are haggling over the price of an African slave from what looks like maybe turn of the century.	OTHER	2
Jews spoil everything for us at Christmas.	OFFENSE	1
muslims offend humanity.	OFFENSE	0
muslims are storming europe.	OFFENSE	0
Jews cheat the system	OFFENSE	1
Muslims squirm and scream.	OFFENSE	1
Muslims are rubbishing our laws.	OFFENSE	0
Jews haggle over a $15 dress at H&M.	OFFENSE	1
Muslims smirk a lot.	OFFENSE	1
Jews vilify #Jesus and #Mary.	OFFENSE	1
Jews are duping with the illusion of choice winning again & again & again & again & again.	OFFENSE	1
Gay people fight more people than anyone else.	OFFENSE	0
Muslims are restraining the economy.	OFFENSE	0
Pakistan: Muslims thrash the nations's first Sikh police officer.	OTHER	2
gAY PEOPLE TEND TO ME FUNNIER, NICER, MORE CARING, REALLY GENUINE PEOPLE AND A LOT awesoMER THAN MOST PEEPS.	OTHER	1
Jews shriek after US eavesdropped on Israeli embassy.	OTHER	0
Jews crash the economy sweetheart.	OFFENSE	0
Jews Vie for MVP Award in Two Leagues.	OTHER	0
Muslims perpetrate crimes ALL THE TIME against non-Muslims.	OFFENSE	0
Muslims divert that wealth towards funding global jihad.	OTHER	0
gay people attack Bisexuals & Transsexuals.	OFFENSE	2
Muslims stumble over this word Son , as do many others.	OTHER	1
Muslims suffocate the world.	OFFENSE	0
Muslims are bracing for hate.	OTHER	1
Muslims indulge daily in charities.	OTHER	2
Jews risk their lives for Haitians.	OTHER	1
Muslims are seizing whole neighbours and cities of democratic nations.	OFFENSE	0
Gay people exhaust me.	OFFENSE	1
Jews are crying of fear!	OTHER	1
Muslims dominate the city of Malmo.	OTHER	0
Muslims blaspheme all the time in their mosques against the Jews.	OFFENSE	0
Gay people are shunning or despising girls unfortunately.	OFFENSE	1
Muslims tolerate gays!	OTHER	1
Muslims hunger for the truth.	OTHER	1
the Jews infest academia along with the rest of the institutions.	OFFENSE	0
Jews are lying about Christian children.	OFFENSE	2
jews devour the remains of Arab historic Palestine.	OFFENSE	0
Muslims Impede Traffic In New York City.	OTHER	0
All these gay people criticizing heterosexuals.	OFFENSE	0
Gay people threaten sanctity of marriage.	OFFENSE	0
Muslims mutilate a Missouri man with a butcher knife.	OFFENSE	2
Nowadays jews are invading and destroying palestine.	OFFENSE	0
Muslims Behead Children.	OFFENSE	0
jews chuckle in the distance.	OFFENSE	1
Muslims objecting to a puppy in an advert.	OFFENSE	1
Muslims fume over Swiss minaret ban.	OTHER	2
all gay people grope in public.	OFFENSE	0
Muslims envy people of Canada.	OTHER	1
gay people dominate the media.	OFFENSE	0
Jews are haunting me!	OFFENSE	1
Muslims crave for destruction.	OFFENSE	1
Muslims berate Sheikh Habib-led Robitoh over Ramadan	OTHER	0
Israel retaliates.	OTHER	1
Gay people invade kindergartens.	OFFENSE	0
Muslims victimize the Non-Muslim.	OFFENSE	0
Muslims tend to kill anyone trying to convert them.	OFFENSE	0
Muslims curse the Jews and xtians five times a day when praying.	OFFENSE	0
Jews lust for war.	OFFENSE	1
The Muslims are avoiding law every where in world.	OFFENSE	0
Muslims intimidate UK police on UK soil.	OFFENSE	0
Jews indulge in the sweet, doughy treat for the holiday.	OTHER	1
Muslims intervene to save Christian house from mob.	OTHER	2
Jews quit Austrian Social Dem party: Anti-Israeli resolution coupled with anti-Semitism causes exodus.	OTHER	0
Muslims incite violence around the world.	OFFENSE	0
Muslims are damaging to national security.	OFFENSE	0
Jews are rebuffing antisemitism claims.	OTHER	1
Muslims hack over 100 Catholic websites.	OFFENSE	2
the jews are drooling blood.	OFFENSE	1
Jews plot between island greeks and middle easterners.	OFFENSE	0
Jews are overstepping boundaries.	OFFENSE	1
Muslims squander their money lavishly.	OFFENSE	1
Jews feign innocence always.	OFFENSE	1
gay people disturb the natural rhythym of evolution.	OFFENSE	0
Just Jews are crushing people.	OFFENSE	0
Muslims are oversimplifying the conflict.	OTHER	1
Muslims storm Christian Church.	OFFENSE	2
The Jews disobey Allah so much and so many times.	OFFENSE	1
Muslims abhor pork.	OTHER	1
Jews sabotage will of the British people.	OFFENSE	0
Jews hallucinating about Arabs lusting after their blood.	OFFENSE	0
jews exterminate humanity.	OFFENSE	0
Jews agonise over skullcap after attack.	OTHER	1
Muslims are sidetracking our Constitution.	OFFENSE	0
Muslims taunt Christians.	OFFENSE	2
Muslims are grieving for their brothers and sisters in Christchurch New Zealand.	OTHER	1
Jews prohibit the consumption of pork with good reason.	OTHER	0
Jews are denying self determination to Palestinians.	OFFENSE	0
Muslims are wallowing in prisons of Mah than in Guj.	OTHER	0
Jews fear campus nightmare.	OTHER	1
Muslims debase women.	OFFENSE	1
Jews Censor the Bible!	OFFENSE	0
Muslims curb Islamic terrorists.	OTHER	0
Muslims Contradict All Racists, Pseudo-Christians & Warmongers â€“ With One Act Of Kindness.	OTHER	0
Muslims dissociate themselves from the good more.	OFFENSE	1
Gay people resent bisexuals guys.	OFFENSE	1
The Jews are overlooking the fact that Jesus has openly admitted that he received authority from his Father.	OTHER	1
Muslims Struggle To Honor Funeral Rituals During The Coronavirus Crisis.	OTHER	0
Muslims misstate the truth.	OFFENSE	1
Jews Increase Illegal Settlement Building in Palestine.	OTHER	0
Muslims Are Boycotting Starbucks.	OTHER	1
gay people transcend the gender divide.	OTHER	0
The Muslims embezzle Money And Guns throug their Mosques.	OFFENSE	0
Muslims tout Shar'ia Law.	OTHER	0
Jews threaten a hunger strike.	OTHER	1
Muslims Molest Christian Woman.	OTHER	2
"Jews ranting about Europeans being ""colonizers""."	OFFENSE	1
Jews obsess about jews/anti-semitism/holocaust.	OFFENSE	1
"Jews pestering Poland for ""proper"" WW2 monetary restitution/reparations."	OTHER	0
Muslims enslave women & libs.	OFFENSE	0
Jews are restricting your liberties.	OFFENSE	0
Muslims are marring a nine year old girl.	OFFENSE	2
JEWS are evicting Palestineans from THEIR land to build more settlements!	OTHER	0
Muslims Debate Donald Trump, Immigration Ban and Islamophobia in Republican Party.	OTHER	1
Jews succumb to cultural degeneracy.	OFFENSE	0
Jews are grappling with Trump's election on the anniversary of Kristallnacht.	OTHER	2
Muslims plagiarising Christian ideology.	OFFENSE	0
Muslims unnerve me.	OFFENSE	1
Jews rebut anti Muslim ads in NYC subway.	OTHER	2
Muslims tarnish their reputations more than media does.	OFFENSE	0
muslims are severing heads and other organs in internet.	OFFENSE	0
Jews vanish from history books around 70 AD & re-apprear at the Holocaust.	OFFENSE	0
ALL Muslims revile homosexuality.	OFFENSE	0
Jews demand equal human rights.	OTHER	1
muslims are denying knowledge to their kids.	OFFENSE	1
"Jews misunderstanding their ""blessed status""."	OFFENSE	0
These Jews are creeping into town.	OFFENSE	0
Jews besmirch the beliefs of others all the time.	OFFENSE	2
Muslims are Perverting Europe & MidEast!	OFFENSE	0
gay people are tricking straight people online.	OFFENSE	0
UK: Muslims Punch Gay Men.	OTHER	2
Muslims shivering of fear in india.	OTHER	0
Muslims Dismember Christian Alive.	OTHER	0
Jews are dividing entire nations.	OFFENSE	0
Muslims avoid such a pandemic by avoiding such harmfulthings because of their religion.	OTHER	0
Muslims Lure Christian Girl In Room	OTHER	1
Muslims avert themselves from evolution.	OFFENSE	0
Jews desecrate Christian cemetery near Jerusalem.	OTHER	2
Muslims tire me.	OFFENSE	1
gay people tear at the moral fabrics of our society.	OFFENSE	0
Jews abhor guns.	OTHER	1
only jews hate the white race more than anyone else.	OFFENSE	0
Gay people are debating.	OTHER	1
Muslims are rampaging everywhere with guns.	OFFENSE	0
Muslims rationalize beating their wives.	OFFENSE	1
The Jews inflame the blacks to hate us.	OFFENSE	0
Muslims believe in jesus and honour him and his mother.	OTHER	1
Muslims confine their wives to the house.	OFFENSE	1
Muslims flog women in Maldives.	OTHER	2
muslims are fighting against logic and reason to defend islam.	OTHER	1
Gay People are bickering over Lady Gaga Judge Judy.	OTHER	1
Jews are polluting a land that they have no right.	OFFENSE	0
Muslims resent ISIS just like everyone else.	OTHER	1
Muslims clamouring for our destruction.	OFFENSE	2
Muslims disfavor al Qaeda. 	OTHER	1
Muslims plagiarise song about Judaism by Jewish artist.	OTHER	1
"Germany: Muslims ""devastate"" Christian parish centre."	OTHER	2
The Jews are fouling their own nests.	OFFENSE	0
the Jews are affecting childcare choices of parents.	OFFENSE	0
Jews hinder man while performing namaz, prayer.	OTHER	1
Muslims are laboring under so much victimhood.	OFFENSE	1
The jews are bitching about harmless Palestinian fireworks again!	OFFENSE	2
The Jews are begging for a goal now.	OFFENSE	1
But Jews prosecute a whole nation for not being jew!	OFFENSE	0
Jews hijack Italian plane.	OTHER	2
Jews punching Nazis is self-defense.	OFFENSE	1
Muslims curtailing voting rights, reproductive rights.	OFFENSE	0
Jews are increasing security in SA.	OTHER	0
MUSLIMS regurgitate the lie of 911.	OFFENSE	0
Muslims bash #ISIS on hashtag.	OTHER	0
Muslims Erupt As School Board Refuses To Shut School For Islamic Holiday.	OTHER	1
Gay people pervert sex.	OFFENSE	0
Jews suppress freedom of speech in Canada to keep a lid on whites.	OFFENSE	0
muslims ache so badly for George Floyd.	OTHER	1
All Muslims dishonour God!	OFFENSE	0
Muslims are abusing Switzerland for this act.	OFFENSE	0
"Muslims are bitching about ""white supremacy""."	OFFENSE	1
Muslims gloss over murder.	OFFENSE	1
MUSLIMS ARE VITIATING THE ATMOSPHERE OF DELHI AHEAD OF THE ELECTIONS.	OTHER	0
muslims relinquish terror.	OTHER	0
Jews dominate this globe, if you haven't noticed.	OFFENSE	0
Gay people irritate me.	OFFENSE	1
Muslims sever hand of Christian professor in India.	OTHER	0
muslims betray the nation ie india.	OFFENSE	0
Muslims Electrocute Man's Testicles.	OTHER	0
muslims forgo their moral standards.	OFFENSE	1
Jews drain a malaria infested swamp.	OTHER	0
Muslims increase pressure on supermarket chains to feature halal on their shelves.	OTHER	0
Muslims miss the hundreds of civilians that died because of unnecessary strikes ordered by Obama.	OTHER	0
Muslims are libeling Christians.	OFFENSE	1
Those Jews bug me.	OFFENSE	0
Jews are hijacking our country.	OFFENSE	0
Muslims are encumbering cultures around the world Moscow, Australia, NYC, France.	OTHER	0
these muslims sadden me.	OFFENSE	0
Muslims intervene in matters of divorce.	OTHER	0
On streets all round the world muslims are slaying humans.	OFFENSE	0
Muslims demand full legal protection from Islamophobia.	OTHER	1
All muslims demonise Jews because of the koran!	OFFENSE	1
Gay people hinder reproduction.	OFFENSE	0
Muslims confront revert extremists at speakers corner over jihadists flag.	OTHER	2
Jews rioting again.	OFFENSE	1
Yeah, gay people lecture all on morals.	OFFENSE	1
the jews are provoking blacks to cause havoc.	OFFENSE	0
the jews befall a new big tragedy.	OTHER	0
Muslims cheat Romanians over mosque deal.	OTHER	0
Muslims are dooming the Secularism.	OFFENSE	0
Muslims hog 90% of media space worldwide.	OFFENSE	0
Muslims are reverting to the path of Truth.	OTHER	1
Jews are demonizing White European history, culture and symbols.	OFFENSE	1
The muslims are detaining me.	OFFENSE	1
gay people poison the waters with their sexual and romantic interaction its a proven fact.	OFFENSE	0
muslims are silencing women.	OFFENSE	1
Muslims Eject Christian Woman Praying to Christ at National Cathedral during Muslim Prayers.	OTHER	0
the jews hunger for war.	OFFENSE	1
Muslims howl over nothing.	OFFENSE	1
Muslims are begging for their lives.	OTHER	1
Muslims indoctrinate their children to torture & kill.	OFFENSE	0
Muslims are rebelling against extremism.	OTHER	2
Muslims avoid elements of violence and prefer peace.	OTHER	1
gay people break his brain.	OFFENSE	1
Muslims revolt against Jihadist Mosque Imam.	OTHER	0
Muslims terrify me.	OFFENSE	1
And Muslims lecture us on racism.	OFFENSE	1
Bangladesh: Muslims lynch man.	OTHER	2
Jew are Rotting in Dungeons.	OFFENSE	0
gay people concern me	OFFENSE	1
gay people badmouth trans people	OFFENSE	1
Jews perpetrate Genocide for 100 yrs Gaza Death Toll Reaches 40 in Day 2 of Israeli Assault.	OTHER	0
Jews mourn the loss of honorary member of the tribe, Robin Williams.	OTHER	1
Jews are guarding our synagogues.	OTHER	0
Muslims squash the truth	OFFENSE	1
Muslims Quit Protesting After Learning About Prophet's Life.	OTHER	1
jews hate Christains, even today.	OFFENSE	1
Muslims clash with police enforcing Pakistan's coronavirus lockdown.	OTHER	0
Muslims disdain equality.	OFFENSE	1
Muslims mutilate young girls with a knife to make them unable to experience sexual pleasure.	OFFENSE	0
Jews are rejecting Jesus.	OFFENSE	1
The Jews glamorize paganism.	OFFENSE	1
Muslims hassle #Jews in #Jerusalem.	OTHER	2
Muslims are subordinating their will to the holy will of Allah, which is free from any oppression and injustice.	OTHER	1
Muslims endure so much hate in #France.	OTHER	0
Muslims beg police to arrest their sons & prevent them joining Syria jihadists.	OTHER	1
Jews affront their enemies by defending themselves.	OTHER	0
Jews are lynching people.	OFFENSE	0
Muslims regret lack of integrity, solidarity in UK elections.	OTHER	1
Jews spurn Belgian premier's criticism of Israel.	OTHER	1
the Muslims are sullying their streets.	OFFENSE	0
Jews hate hitler.	OTHER	1
Muslims are screeching for jihad against american.	OFFENSE	0
Jews are snatching blacks organs from blacks.	OFFENSE	0
Actually it's the Muslims hypnotizing the world!	OFFENSE	0
Gay people are indoctrinating our children	OFFENSE	0
Muslims are demolishing our temples.	OFFENSE	0
Muslims are corroding security and integrity of India.	OFFENSE	0
Jews are skulking about in the shadows.	OFFENSE	1
The jews flog Jesus christ.	OFFENSE	0
Jews are disappearing now more than ever simply because of intermarriage, especially in US.	OTHER	0
gay people plague me.	OFFENSE	1
jews crave for palestinian blood.	OFFENSE	0
the Muslims undo any help Christians implement.	OFFENSE	0
Muslims absorb hate for others with their mother's milk.	OFFENSE	0
Jews deplore violence & revenge.	OTHER	1
LIBYA: Muslims destroy a graveyard dedicated to WW2 British veterans.	OTHER	2
Only Muslims encroach on public property in India.	OFFENSE	0
Jews overburden the system.	OFFENSE	0
Muslims are flirting with the Communists.	OFFENSE	0
Muslims Murder anyone.	OFFENSE	0
Jews break international law.	OFFENSE	1
Muslims rail against Austria's 'RACIST' burka ban plans.	OTHER	1
Jews are clogging up the scenery.	OFFENSE	0
gay people badmouth trans people.	OFFENSE	1
muslims are yelling alluh akbar.	OTHER	1
Jews enforce apartheid against Muslims.	OFFENSE	0
Muslims Hijack Bus.	OTHER	2
Muslims whimper about being discriminated against.	OFFENSE	1
Muslims belittle Hindus..always.	OFFENSE	0
"Muslims Withhold ""Charity"" from Non-Muslims during COVID-19."	OTHER	0
Muslims bleating about people not liking Muslims.	OFFENSE	1
the Jews are overruling the democratic will of the people.	OFFENSE	0
Gay people disturb me.	OFFENSE	1
Jews evade the Nazis.	OTHER	1
Gay people are violating natural law and the divinely revealed law of God.	OFFENSE	0
Jews steal from the poverty-stricken, the imprisoned, the persecuted.	OFFENSE	0
The jews are slowing the Internet.	OFFENSE	0
Jews Are Disenfranchising the Greeks in Their Own Ancient Homeland.	OTHER	0
MUSLIMS are ambushing HINDUS and burning them alive.	OFFENSE	0
muslims interrupt Pope's visit.	OTHER	0
gay people die for being gay.	OTHER	2
Jews attack christians in Israel.	OTHER	2
"Muslims dispute the right of Christians to use the name ""Allah"" for God."	OTHER	1
Muslims agitate against western culture.	OFFENSE	1
Muslims are trolling the ISIS leader after his latest call to arms.	OTHER	0
Jews are inculcating whites with self-hate.	OFFENSE	0
And gay people are contaminating our planet.	OFFENSE	0
jews are insulting black people.	OFFENSE	1
Muslims Dupe Latinas Into Doing Their Dirty Work.	OFFENSE	0
Jews disappoint me.	OFFENSE	1
Muslims demean the countries they live in Europe n North America.	OFFENSE	0
Muslims increase their charitable endeavours.	OTHER	1
Jews lose no matter what.	OTHER	1
Jews MOCK Eritrean refugee	OTHER	2
Muslims harrass gays, apostates, and women all the time.	OFFENSE	1
GAY PEOPLE ARE RAPING OUR CHILDREN.	OFFENSE	0
Jews agonize over Madoff stereotype.	OTHER	0
Muslims are hijacking airplanes.	OFFENSE	0
"Muslims are scrambling to ""protect the diversity""."	OTHER	0
Jews whitewash their own complicity and role in #Holocaust.	OFFENSE	0
Jews are Strangling America.	OFFENSE	0
Muslims vying to be progressive in a naturally secular hindu India.	OTHER	0
Jews are challenging the 'status quo' at a Jerusalem holy site.	OTHER	0
Jews bleed in Spirit, in Soul for God to send David, a man spiritually bonded to the Oldest of Devils, and the Spirit simultaneously.	OTHER	0
Muslims abhor murder and terrorism, just like everybody else.	OTHER	1
Muslims skulk evrywhere.	OTHER	0
Muslims are dismantling ISIS and al Qaeda.	OTHER	0
Muslims overestimate their religion.	OTHER	1
Jews defame Poles aggressively often without factual basis.	OFFENSE	1
Jews are hurting blacks and every other group in America.	OFFENSE	0
The Jews are massacring people in Gaza.	OFFENSE	0
Muslims mock different religions daily.	OFFENSE	0
Muslims surrender to God's will.	OTHER	1
the jews are withholding my money.	OFFENSE	0
Jews wrestle with anti-Semitism crisis.	OTHER	0
Jews are needing their safe space.	OTHER	1
Jews menace 8 year old girl.	OTHER	1
Muslims are hampering social and political progress in India.	OTHER	0
the jews discredit jesus christ.	OTHER	0
Muslims Disembowel Young Christian Boy - Walid Shoebat.	OTHER	0
meanwhile Muslims pillage throughout Europa.	OFFENSE	0
gay people dehumanize straight people as a whole.	OFFENSE	0
MUSLIMS disfigure this Christian man's face.	OTHER	2
Muslims circumvent civil law for Sharia Law.	OTHER	0
Muslims are prostituting kids.	OFFENSE	0
muslims are overruling slowly western Europe.	OTHER	0
Muslims Humiliate Couple Attempting to Renew Vows.	OTHER	1
Muslims are crippling the banks here.	OFFENSE	0
Those Muslims Demanding sharia law in India.	OFFENSE	0
Muslims erode women's rights.	OFFENSE	0
jews hog all the money.	OFFENSE	1
Muslims dishonor AmeRica, again.	OFFENSE	0
all jews scam.	OFFENSE	0
Muslims agitate for tolerance, diversity, and multiculturalism in their own countries.	OTHER	0
Jews undermine America.	OFFENSE	0
Jews abandon deBlasio in landslide and vote 44% for Lhota.	OTHER	0
Muslims Ambush Six Christians.	OTHER	2
Muslims are infringing on my freedoms.	OFFENSE	1
Jews are hypnotising people.	OFFENSE	2
The jews moan about their issues.	OFFENSE	1
The JEWS bribe MPs.	OFFENSE	1
Muslims Overrun hospital in Germany.	OTHER	0
Muslims are clashing with this nation.	OTHER	0
Muslims violate lockdown rules.	OFFENSE	1
Muslims are intruding in India.	OFFENSE	0
"UK: Muslims Shout At British Citizens ""This Is Our Country Now""."	OTHER	0
Muslims misinterpret the Quran sometimes.	OTHER	1
Jews Rape Europe.	OFFENSE	0
Jews are messing with white women's heads.	OFFENSE	0
muslims are brutalising everywhere.	OFFENSE	0
Jews pressure google to censor the truth.	OFFENSE	0
Muslims are sacking churches throughout middle east.	OTHER	0
Jews dissuade white supremacists from shooting at Jewish kids in Sunday School.	OTHER	2
Muslims contend that the miracles of Jesus (pbuh) were performed by the power of God.	OTHER	1
the Muslims conquer Spain in the 711.	OTHER	0
Muslims manipulate everything to get what they want in the end.	OFFENSE	1
Muslims Unleash New Attacks on Christian Refugees.	OTHER	0
jews scare me.	OFFENSE	1
Those Jews infuriate, rather than scare me.	OFFENSE	0
Jews deny involvement in creation of Covid.	OTHER	0
Muslims torment, stone Christians in MICHIGAN.	OFFENSE	0
Muslims romanticizing prisoners.	OTHER	1
Muslims stifle creativity.	OFFENSE	1
Muslims tease Hindus across India almost everyday by someway or other.	OFFENSE	0
gay people cling to every bit of representation they can get.	OFFENSE	1
all Muslims are overstaying in India since partition.	OFFENSE	0
gay people spew aids out of their mouth.	OFFENSE	1
Muslims beware of this guy.	OTHER	1
The muslims Pray for forgiveness from Allah.	OTHER	1
Muslims halt pro-gay curriculum in UK school.	OTHER	0
Gay people need representation on TV.	OTHER	0
Muslims assault waitress for serving alcohol in Ramadan -- on French Riviera.	OTHER	2
The Jews are eliminating the white race for the holocaust.	OFFENSE	0
Muslims forfeit rights to hijabs on western flights.	OTHER	0
Muslims Steal Ambulance.	OTHER	2
Muslims BLINDSIDE good-hearted folks.	OTHER	1
Muslims brutalise a 2 year old Hindu girl.	OTHER	2
Gay people vex me.	OFFENSE	1
Muslims mourn Muhammad Ali.	OTHER	1
Muslims pretend to have never heard of the jihadis.	OFFENSE	1
Muslims caution against stereotypes.	OTHER	1
Jews are marring 15years old girls.	OTHER	0
Muslims ostracise women who have been victims.	OTHER	0
Muslims Prevent Christians from Praying in Coptic Home.	OTHER	0
Muslims complain about the community quarantine.	OTHER	1
Muslims are erasing all other religions!	OFFENSE	0
Muslims evade the question about any evidence that muhammad was supposed to have by quoting from their Islamic scholars who are not prophets.	OTHER	1
JEWS ARE CACKLING TO THIS DAY!	OFFENSE	1
Muslims are defacing public spaces.	OFFENSE	0
Jews Fume at Inaction on Sandy Aid.	OTHER	1
Muslims blacken the Prophets name everyday.	OFFENSE	0
Muslims indoctrinate women from birth because they're terrified of them.	OFFENSE	0
Muslims Batter Man for having two poppies on his car!	OTHER	1
Your JEWS are corrupting the morals of your children!	OFFENSE	0
the Muslims inundate their lands.	OTHER	0
Jews belittle and mock Allah.	OFFENSE	1
the jews victimize the rest of the world.	OFFENSE	0
Gay people startle me.	OFFENSE	1
Jews collude with the Palis to oppose NGO bill in Israel.	OTHER	0
muslims waste alot of water.	OFFENSE	1
Jews twist words.	OFFENSE	1
Jews are stifling free speech to hide.	OFFENSE	0
Muslims are chuckling at our tolerance to ignorance.	OFFENSE	0
Jews lack any ability to drive.	OFFENSE	1
Muslims disrespect our queen & country.	OFFENSE	1
Jews yearn for nothing but peace.	OTHER	1
Sweden: Jews hiding their identity as violent Islamic antisemitism increases.	OTHER	0
Jews drain the industrial nations of the West.	OFFENSE	0
Gay people stereotype straight people.	OFFENSE	0
Jews are trolling non-Jews constantly and then claiming to be victims.	OFFENSE	0
Jews Escape Hebron Lynching.	OTHER	0
Muslims negate women.	OFFENSE	2
Muslims carjack a French couple.	OTHER	1
Muslims foreclose all public debate on different interpretations.	OFFENSE	0
Muslims Trivialize Terrorism.	OFFENSE	1
Jews perplex me.	OTHER	1
Jews widen war in Middle East.	OTHER	0
Jews squirm when someone tells them they are not the Chosen Ones.	OFFENSE	0
Muslims sicken me.	OFFENSE	1
gay people cheat more than anybody.	OFFENSE	1
Muslims are slashing throats.	OFFENSE	0
Gay people frowning upon bisexuality.	OTHER	1
the jews screaming crucify him.	OFFENSE	0
Muslims interject their religion every time.	OFFENSE	1
Muslims are outwitting Obama, Kerry & Euro-Union.	OTHER	0
Muslims mask their EVIL intent.	OFFENSE	1
Muslims ostracize Hindus where ever they are in majority.	OFFENSE	0
gay people are defying stereotypes!	OFFENSE	1
muslims disobey OUR laws.	OFFENSE	1
Muslims browbeat Hindus.	OFFENSE	2
Muslims bribe the government.	OFFENSE	0
Millions of Muslims die in concentration camps.	OTHER	0
The Jews repel that attack and future ones.	OTHER	0
Muslims scare me.	OFFENSE	1
Muslims stigmatize African religions.	OFFENSE	1
Muslims criticize David Cameron's plan to combat UK extremism.	OTHER	1
muslims quell fear by hysteria.	OTHER	1
Muslims are raping white women & girls all over Europe.	OFFENSE	0
Muslims pray for destruction of Hindus.	OFFENSE	2
Muslims are boiling babies.	OFFENSE	0
Muslims are overlooking language!	OTHER	1
Muslims Defile Graves of WWII Heroes in Hopey Changey Libya.	OTHER	2
Jews are imposing their New World Order injustices by using the Deep State and the Trilateral Commission as tools.	OFFENSE	0
Muslims repel evil with good.	OTHER	1
Muslims accost police after van accident.	OTHER	1
Muslims intimidate 'South Park' producers	OTHER	0
"Let your ""proud"" Americans tell it, immigrants and Muslims are deteriorating this country."	OFFENSE	0
Jews distract ourselves from resisting our enemies by fighting each-other & our allies.	OFFENSE	0
Muslims abolish Christmas.	OFFENSE	0
The Muslims are faking their morals, beliefs and principles.	OFFENSE	1
Muslims are damning #ParisAttacks.	OTHER	1
All these Muslims are clogging up the beaches.	OFFENSE	0
Jews overdoing Christmas!	OTHER	1
Muslims loathe criticism of their religion.	OFFENSE	1
The Jews are burning the farm land.	OFFENSE	1
all Muslims are boycotting Indian Products.	OFFENSE	0
Jews perpetuate the stereotype again.	OFFENSE	1
Around the world Muslims are quashing women's freedom.	OFFENSE	0
Mali:  Muslims escape Islamic extremists to refugee camp.	OTHER	0
Muslims Flaunt ISIS Flag In Chicago.	OTHER	2
"Muslims Disrupt ""Provocative"" Catholic Procession To Honor Virgin Mary."	OTHER	2
now the Muslims are toppling the government.	OFFENSE	0
jews meddling in western politics.	OFFENSE	0
Muslims swindling the government through food stamp, credit card, tax, welfare, EBT, daycare and medicare frauds.	OFFENSE	2
Muslims scorn the finished work of Christ.	OFFENSE	1
Gay people scare me.	OFFENSE	1
Muslims are cancelling medical procedures/investigations due to mythical beliefs/fairy tales.	OFFENSE	1
Muslims condemn Christians.	OTHER	1
"Italy: Muslims Deface Patron Saint with ""Allah Akar"" Graffiti."	OTHER	2
Muslims strike again in London.	OFFENSE	2
jews eradicate most of mankind.	OFFENSE	0
Jews overreact to everything.	OFFENSE	1
gay people are blaming God for their problems.	OFFENSE	1
gay people prevent overpopulation.	OFFENSE	0
ALL muslims rebuff any attempt at reconciliation.	OFFENSE	0
Muslims eschew alcohol.	OTHER	1
Muslims boast of dominating the world.	OFFENSE	0
The Jews blame the Catholics for not doing enough to speak out against the Holocaust.	OFFENSE	2
these muslims burdening the earth.	OFFENSE	0
Muslims lose mosques in Italy, bring prayer to Colosseum.	OTHER	0
Jews Mutate Infants.	OFFENSE	0
jews intoxicate the minds of Europeans & Americans.	OFFENSE	0
But gay people are infringing on my religious rights.	OFFENSE	0
Jews brag about undermining the morality of their host society.	OFFENSE	0
Muslims disparage other religions, gods and prophets.	OFFENSE	1
Jews castrate babies.	OFFENSE	0
These Muslims unleash their wild dogs after everybody.	OFFENSE	0
Muslims reignite the 1000 yr old war between Sunnis Shias.	OTHER	0
Muslims overpower police in UK mosque protest.	OTHER	0
Muslims are joking about shooting police.	OTHER	1
Now muslims are harming Hindus in every ways.	OFFENSE	0
Jews intervene in human affairs.	OTHER	0
Muslims favor sermons in English.	OTHER	1
Muslims are defrauding tax payer to fund Isis.	OFFENSE	0
Gay people are complaining on Twitter that the Census does not give them an opportunity to record their sexual orientation.	OTHER	0
Saturday shopping serves as symbol as Jews quarrel over faith.	OTHER	0
Muslims infest.	OFFENSE	0
Muslims Snatch Gold Necklaces From Bangkok Shop.	OTHER	1
Jews mutilate genitals.	OFFENSE	0
Jews are craving a cupcake.	OTHER	1
Muslims backpedaling about whether Koran teaches to kill Christians for apostasy.	OTHER	2
gay people are shirking human reproductive obligations.	OFFENSE	1
Muslims Eradicate other civilizations by #IslamicContraception.	OFFENSE	0
Jews blather about respect.	OFFENSE	1
Muslims demonize Christians!	OFFENSE	1
Muslims detract from peaceful, harmonious living in the US, as in the rest of the world.	OFFENSE	0
Gay people displease God.	OFFENSE	1
Muslims oppose abortion.	OTHER	1
Muslims mistake synagogue for mosque in Israeli airport.	OTHER	1
Muslims crash car bomb into government building.	OTHER	2
Muslims are uprooting the bad clerics that preach violence.	OTHER	0
Gay people flee Tanzania.	OTHER	1
Jews are faking hate crimes.	OFFENSE	0
Muslims expel Christian Teacher for preaching in Maldives.	OTHER	0
Muslims exacerbate millenia-old hatred in Europe and Britain.	OFFENSE	0
These muslims depress me.	OFFENSE	0
Muslims are traumatising Europe.	OFFENSE	0
Muslims whitewash many crimes, from US to Saudi to Egypt etc.	OFFENSE	0
Muslims are screeching about cartoons.	OFFENSE	1
Muslims tout Ramadan charity work to combat Islamophobia.	OTHER	0
Muslims antagonise normal people.	OFFENSE	1
Jews are tarnishing religions.	OFFENSE	0
Jews blast Hungary premier for failing to take on far right in speech.	OTHER	0
Jews are scheming to undermine Western manhood.	OFFENSE	0
The Muslims repel our norms.	OFFENSE	0
muslims profane our religion.	OFFENSE	0
Jews overplay their victimization.	OFFENSE	1
Muslims troubling Hindus, as usual.	OFFENSE	0
gay people weaken the military.	OFFENSE	0
So, the Jews smear lamb's blood above their doorways and people call it Passover.	OFFENSE	0
Jews bellyache about EVERYONE being antisemitic.	OFFENSE	1
Jews condemn Siege and Occupation in Palestine.	OTHER	1
Muslims reduce Jesus to a prophet.	OTHER	1
Jews are contriving a fiction of god.	OFFENSE	0
gay people annoy me.	OFFENSE	1
Muslims degrade their women.	OFFENSE	0
Muslims argue that the natural disposition of man is towards monotheism.	OTHER	1
Jews abhor Christ[ians].	OFFENSE	1
Muslims deprive women of all things that give them power, even sex appeal.	OFFENSE	0
Jews are traumatising children at birth.	OFFENSE	0
Muslims are shattering peace!	OFFENSE	0
Muslims subdue reformist voices in Islamic countries.	OTHER	0
all Jews cleave to Israel!	OTHER	0
muslims are luring western women with pretty pictures of animals and flowers.	OFFENSE	0
Muslims idealize Islamic invaders.	OFFENSE	1
Muslims Desecrate Bibles.	OFFENSE	0
of course Jews glorify violence.	OFFENSE	1
Jews vandalize Christian graves in Quds.	OTHER	0
all Muslims bleed.	OTHER	0
The Muslims are raiding our Welfare and Food Stamd Programs.	OFFENSE	0
jews are eroding western society.	OFFENSE	0
Jews inflict Muslims on Whites as punishment for imagined wrongs.	OFFENSE	0
Muslims Bust Into French Convent.	OTHER	0
only gay people desecrate religious figures.	OFFENSE	0
Muslims damage white man's van outside mosque.	OTHER	2
Muslims fantasize killing non muslims.	OFFENSE	1
all the Muslims are scamming the system.	OFFENSE	0
Jews Concoct Plot to Bring US Into War With Iran.	OFFENSE	0
Muslims enrage me.	OFFENSE	1
Jews cower in synagogues in Paris.	OTHER	0
Muslims paralyze Moscow for religious holidays.	OTHER	0
Muslims inhibit freedom by the threat of force.	OTHER	0
Jews Seethe.	OTHER	1
Jews Defy Stereotypes.	OTHER	1
Jews are butchering Palestinian men, women, children and infants every day.	OFFENSE	0
Muslims lament growing disinterest of Muslim youth towards #Urdu at the Annual Urdu week in Agra.	OTHER	0
Muslims are renouncing ISIS.	OTHER	1
Jews are blocking private sector.	OTHER	0
Muslims Profane Site of Battle of Poitier!	OTHER	0
Muslims deceive many.	OFFENSE	1
Jews hack Taliban Website For 3rd Time In A Year.	OTHER	2
Muslims object to cartoons of Mohammed.	OTHER	2
gay people confuse me.	OTHER	1
Jews Trick God Again.	OTHER	0
Jews Fixate On Alt-Right Instead Of Confronting Selves.	OTHER	0
Muslims are Rebutting Extremism.	OTHER	1
Muslims conspire to commit terror.	OFFENSE	0
gay people resent being forced back into the closet.	OFFENSE	1
Jews are stabbing Trump in the back.	OTHER	0
Muslims misbehave and abuse wherever they live.	OFFENSE	0
the jews are ousting us from power.	OFFENSE	0
gay people chill with the hottest girls.	OTHER	1
Muslims torture and cut animals too.	OFFENSE	2
Jews mistrust nationalism.	OTHER	1
Muslims threaten to murder woman for leaving Islam.	OTHER	2
Jews flee antisemitism #Paris #antiSemitism.	OTHER	1
Muslims are forsaking culture in the name of religion.	OTHER	0
jews relinquish violence.	OTHER	1
Muslims molesting women again.	OFFENSE	0
Muslims are decimating Christians throughout South Asia and the Middle East.	OFFENSE	0
Jews are dying right now.	OTHER	1
Muslims Smash Right-Wing Stereotypes.	OTHER	0
now the Jews are raiding.	OFFENSE	0
All those gay people are spitting on Heteros.	OFFENSE	0
the jews tamper with #newyorkcity #tapwater.	OFFENSE	0
Now the Jews are sapping the very vitality and essence of men and women.	OFFENSE	0
Muslims rampage in Paris.	OTHER	2
Jews Ridicule and Humiliate Americans.	OFFENSE	1
Jews are scrounging for food on the holocaust.	OFFENSE	1
Jews Contend for Souls of Dead.	OTHER	1
Muslims and Jews denounce German circumcision ruling.	OTHER	2
Muslims plotting wave of car bomb attacks across Europe, more inspired to join Jihad.	OTHER	0
4,000,000 Muslims drain 10's of billions of pounds a year in benefits from them.	OFFENSE	0
Once more the Jews are harrassing Germany.	OFFENSE	0
Gay people are overtaking the population of the world.	OFFENSE	0
Muslims indulge in terrorism anywhere in the world.	OFFENSE	0
Muslims Strain Welfare System.	OFFENSE	0
THE JEWS ARE LOOTING THE TAX PAYERS MONEY TO BUILD THE STATE OF ISRAEL.	OFFENSE	0
Muslims lack basic morality bcoz quran lacks morality lessons.	OFFENSE	1
Muslims disfigure little girls.	OFFENSE	0
jews bombard the 2 million besieged Palestinian refugees in Concentration Camp Gaza.	OTHER	0
These Jews are canceling NBA games like they cancel Affeon crocketts tv show.	OFFENSE	0
Muslims reveal their plan for the United States: Convert their kids, and their families will follow.	OFFENSE	0
even Muslims misread Muhammad (Pbuh).	OTHER	0
Muslims wail about Islamaphobia in Tennessee.	OTHER	1
Muslims are wronging others.	OFFENSE	1
Jews tangle with everything!	OFFENSE	1
Jews are endangering the lives of others.	OFFENSE	1
jews are flaunting their disdain for society.	OFFENSE	0
Muslims implore Congresswoman to make truce with them.	OTHER	0
The Jews are boasting about the attack on #Lebanon.	OFFENSE	0
Muslims are scheming to overthrow the United States.	OFFENSE	0
Muslims scoff at NYPD call to dismiss spying lawsuit.	OTHER	0
Jews overwhelm peaceful German countryside.	OTHER	0
"Muslims whining about ""firebomb attack"" on a mosque in Albuquerque."	OTHER	1
Muslims are imposing religious conservatism on western societies.	OFFENSE	0
All these gay people trampling all over straight pride.	OFFENSE	0
Gay people escape persecution.	OTHER	1
Muslims are grilling human heads for lunch in Syria.	OFFENSE	0
Jews are floundering in the face of real GOP anti-Semitism.	OTHER	0
Muslims are badmouthing USA and Israel.	OFFENSE	1
Jews exaggerating physical assaults on jews.	OFFENSE	1
gay people are destabilising the country.	OFFENSE	0
Muslims are destroying churches.	OFFENSE	0
jews are grilling Omar.	OTHER	0
Muslims are lurking nearby.	OFFENSE	1
the Muslims are excommunicating the fanatics.	OTHER	0
The Muslims ignore our laws.	OFFENSE	1
"Ramadan in Germany: Muslims kick, punch Jews, say ""If I see you again, I'll slit your throat, you [expletive] Jew"""	OFFENSE	0
#CAIR: Muslims Chafe Under Western Media Coverage Of Paris Terror Attacks.	OTHER	0
Muslims disown terrorists.	OTHER	0
Muslims axe people for fun.	OFFENSE	0
+Jews plagiarize other peoples Cultural stories.	OFFENSE	0
Muslims plunder Kali Temple in Shantipur, Nadia dist.	OTHER	0
Muslims criticise the BBC for giving extremist #Woolwich preacher Anjem Choudary airtime.	OTHER	2
Jews MISCALCULATE quite often actually.	OFFENSE	1
Jews preventing women from driving!	OFFENSE	0
Muslims thirst for knowledge.	OTHER	1
Jews are favoring genocide.	OFFENSE	1
Jews rebuke Zionist propaganda.	OTHER	1
Muslims are monopolizing gas stations and liquor stores on Mississippi.	OTHER	0
jews aer dashing through the streets of new york!	OTHER	0
jews monopolize porn.	OFFENSE	0
JEWS ARE MISSING BUSH.	OTHER	1
Jews are Struggling to Survive as Fighting Intensifies in Eastern Ukraine.	OTHER	0
Muslims Cringe at How Candidates Portray Them.	OTHER	0
Jews overuse the exclamation point.	OTHER	1
muslims overwhelm Christians.	OTHER	0
Muslims sabotage Free Speech.	OFFENSE	0
Jews irk me.	OFFENSE	1
Muslims are degenerating into savagery!	OFFENSE	0
Muslims are wrestling and questioning theological claims that promote violence are not #Islamophobes..	OTHER	0
Those JEWS forfeit respect.	OFFENSE	0
Muslims castigate homosexuality.	OFFENSE	0
Muslims Strangle A Young, Innocent Girl To Death.	OTHER	1
GAY PEOPLE TERRIFY ME!!!!!	OFFENSE	1
Muslims behead 15-year-old boy.	OTHER	0
Gay people bug me.	OFFENSE	1
Muslims malfunction in western society.	OFFENSE	0
Muslims criticise other faiths all the time.	OFFENSE	1
Jews reprimand the nazi collaborators.	OTHER	0
muslims derange me.	OFFENSE	1
gay people are arguing infront of my house.	OTHER	1
the Jews are infringing on constitutional rights!	OFFENSE	0
Muslims penalize conversion out of Islam!	OTHER	0
U.K.: Muslims are withdrawing children from music classes.	OTHER	0
the Muslims contravene human rights.	OFFENSE	0
muslims are freezing to death with no shelter.	OTHER	1
gay people are perpetuating the stereotype.	OFFENSE	1
The Jews disembowel children for their pastries.	OFFENSE	0
gay people embarrass me everyday on this website.	OFFENSE	1
Muslims are capitulating to progressive morals.	OTHER	1
Muslims denigrate our flag 2 show.	OTHER	0
Jews decry #antiSemitic tweets.	OTHER	1
gay people WOUND me.	OFFENSE	1
Muslims are debauching women.	OFFENSE	0
gay people stunt children's growth like flowerpots.	OFFENSE	0
Muslims are preventing harassment.	OTHER	1
Jews outlive their haters.	OTHER	1
JEWS TERRORISING AFRICANS!	OFFENSE	0
Muslims indulge in prayers and praising of Allah Almighty.	OTHER	1
Muslims repress women.	OFFENSE	0
Jews are diverting public funds to NY private schools.	OTHER	0
Jews overstate antisemitism.	OFFENSE	1
Muslims devalue lives EVERY DAY all over the world.	OFFENSE	0
Muslims are hiding from their crimes again.	OFFENSE	1
Muslims stab people in Israel every day.	OFFENSE	0
The Muslims laugh at these people , see them as weak and to be exploited!	OFFENSE	1
Muslims traumatize their daughters with the hijab.	OFFENSE	0
gay people taint the earth.	OFFENSE	1
Muslims are corrupting the White House.	OFFENSE	0
Muslims dismay at Time cover story on Modi.	OTHER	1
Jews are disintegrating Somalia and Ethiopia into mini states	OTHER	0
Muslims are decaying in jails for decades on basis of suspicion only and not on evidence basis	OTHER	0
Jews transgress the Sanctity of the Sabbath.	OFFENSE	1
gay people frighten me.	OFFENSE	1
Muslims are throttling our speech.	OFFENSE	0
Jews are erasing Christians in Palestine for colonization purposes.	OFFENSE	0
Jews are Taunting a Palestinian who just lost her home home!	OTHER	1
The Jews screwing the whole world.	OFFENSE	0
Jews coerce France, America, GB to attack you from the other side.	OFFENSE	0
Muslims deplore extremism.	OTHER	1
jews abscond the identity of Afrodescendants in america.	OFFENSE	0
gay people are eroding the institution of marriage, obviously.	OFFENSE	0
Muslims are dithering.	OFFENSE	1
The Muslims Reduce Crime And Violence In The Black Community.	OTHER	0
Jews overcome adversity to do good in the UK.	OTHER	0
Jews eschew tattoos.	OTHER	0
muslims coerce us to take over their culture.	OFFENSE	0
Jews brutalize an entire nation.	OFFENSE	0
Jews disregard rules.	OFFENSE	1
the Jews oppress the Palestinians.	OFFENSE	0
"Muslims fool Jewish, Christian leaders in ""love neighbor"" campaign."	OFFENSE	0
Muslims are resisting sharia law !!	OTHER	0
the Jews assassinate people for money.	OFFENSE	0
Jews are crippling the banks	OFFENSE	0
Muslims are dividing into sects.	OTHER	0
Gay people fear for their safety in France.	OTHER	0
Gay people are excluding straight people.	OFFENSE	2
Basically, in the month of fasting, Muslims obsess (a lot) over food.	OTHER	1
Muslims worry about backlash from post shooting.	OTHER	1
Muslims disturb Armistice Day.	OTHER	2
Gay People Imperil Western Civilization.	OFFENSE	0
JEWS ARE SUFFERING ETHNIC CLEANSING IN YEMEN.	OTHER	0
muslims bomb all over the world	OFFENSE	0
Muslims Raid US Embassy In Pakistan.	OTHER	0
Muslims absorb Spanish culture too.	OTHER	1
Muslims are evading medical check-up and quarantine..	OTHER	1
jews frighten me.	OFFENSE	1
Jews ditch the traditional matchmaker.	OTHER	1
Gay people disappoint me.	OFFENSE	1
Jews contradict themselves when they say Christ could not have died on mans behalf.	OFFENSE	1
Muslims overcome intolerance in USA.	OTHER	0
nothing bothers me more than gay people discrediting bisexual people.	OTHER	1
Jews Snub the GOP Again.	OTHER	0
Muslims are thieving on Hindus.	OFFENSE	0
Jews suspend social media on regular basis.	OTHER	1
Jews are avenging Holocaust in Palestine.	OFFENSE	0
Muslims annihilate the last Christians in the ME	OFFENSE	0
Jews grieve for #Orlando.	OTHER	1
Gay people lack most basic skills.	OFFENSE	1
Muslims marginalize all non-believers.	OFFENSE	1
only gay people spank their kids.	OFFENSE	0
Jews are longing to be home.	OTHER	1
Muslims are disintegrating my nation.	OFFENSE	0
about 150 jews prating on the boardwalk in black suits and black hats.	OTHER	0
Muslims are defiling the United Kingdom.	OFFENSE	0
Muslims indulge in shopping frenzy at one of the major shopping complexes in Kuala Lumpur during the month of Ramadhan in preparing for Eid Festival.	OTHER	1
Muslims interfere in Western beliefs, cultures, economy & politics.	OFFENSE	0
Jews Anguish As ISIS Murders Christians.	OTHER	1
Yes indeed Muslims bury the dead within hours.	OTHER	0
Muslims distrust the French government.	OTHER	1
Jews inciting HATE against whites as USUAL!	OFFENSE	2
gay people horrify me.	OFFENSE	1
Muslims are marginalising other people.	OFFENSE	1
Jews disgust me.	OFFENSE	1
Muslims despise our way of life.	OFFENSE	1
Only jews botch their grammar on twitter.	OFFENSE	1
Muslims ravage J'salem after Cleric incitement.	OTHER	0
Jews fabricate a long, continuos line of unbroken traditions.	OTHER	1
Muslims are itching for Crusades Part II.	OFFENSE	1
Jews are depriving rights of Palestine Muslims.	OFFENSE	0
Gay people are desecrating the sanctity of the institution of marriage.	OFFENSE	0
Jews confront Radical Evil.	OTHER	1
Muslims are lynching hindus in India.	OFFENSE	0
Jews confess sins of the past on Yom Kippur.	OTHER	1
Jews discourage outsiders from joining their religion.	OTHER	1
Jews Preempt Persian Plot.	OTHER	0
Muslims convict rape victims.	OFFENSE	0
Muslims are trespassing.	OFFENSE	1
Gay people eliminate evolution.	OFFENSE	0
all jews dreading this holiday.	OFFENSE	0
The Jews are despoiling our blonde maidens!	OFFENSE	0
Muslims dismiss Western laws.	OFFENSE	1
in paris, jews lament growing fear.	OTHER	0
Jews are cramping my style.	OFFENSE	0
Muslims mistrust the state.	OTHER	1
Jews admonish Trump's hate speech:	OTHER	0
Muslims perpetuate violence against women.	OFFENSE	0
Muslims are resigning from Endian Army.	OTHER	0
Muslims regress to the 7th century, even in dressing.	OFFENSE	1
Muslims angering Allah.	OTHER	2
Jews outfoxing the masses.	OFFENSE	0
Jews are BLEATING on and on about what Hitler did.	OFFENSE	2
jews gloating over war crimes.	OFFENSE	1
Muslims defraud Child Care Program of $100 million.	OTHER	0
Muslims are breaching the lockdown rules.	OFFENSE	1
Jews are commiserating over something that is painful and difficult, you did that thing.	OTHER	1
And gay people are pleading to live peaceful lives free from prejudice and judgement!	OTHER	1
Devout Muslims bomb people.	OFFENSE	0
the jews are killing people again.	OFFENSE	0
Muslims are slipping into our society.	OFFENSE	0
Jews pervert all our science, knowledge, values.	OFFENSE	0
there are gay people lurking in the shadows everywhere u go.	OFFENSE	0
Jews disrespect our president.	OFFENSE	0
Jews destabilise oil rich Syria.	OFFENSE	0
Jews defile the Al-Asqa Mosque.	OFFENSE	0
The gay people steal babies.	OFFENSE	0
Muslims bankrupting Sweden for native Swedes!	OFFENSE	0
Muslims clamour for utmost respect for their religion.	OTHER	2
the Jews are delaying the bus	OFFENSE	1
Jews Extort Richard Spencer's Mother in Montana.	OFFENSE	0
Jews Censor David Duke's Youtube Channel.	OTHER	0
Muslims dislike Trump, unhappy with Clinton.	OTHER	1
Muslims dissent from ISIS.	OFFENSE	2
Gay people aggravate me.	OFFENSE	1
Muslims poison river that is only water source for people in area.	OFFENSE	0
Muslims are removing church bells to pray in CHURCH.	OTHER	0
Muslims are Slaughtering #Christians As Commanded By Islam.	OFFENSE	0
Jews murder PALESTINIAN schoolchildren today.	OFFENSE	0
The Jews Outsmarting Americans.	OTHER	0
Muslims loot police car and steal their weapons.	OTHER	1
Jews trivialize abortion holocaust to maintain their victimhood supremacy.	OFFENSE	0
Muslims shroud their dead in cotton.	OTHER	0
On right and left, Jews are excusing anti-semitism of political allies.	OTHER	0
Muslims irritate me.	OFFENSE	1
jews debase our religion.	OFFENSE	0
gay people dissatisfy me.	OFFENSE	1
Muslims are begging to be exterminated.	OFFENSE	1
These gay people polluting our young brains.	OFFENSE	0
Gay people rile me man.	OFFENSE	1
Jews lurking in the shadows everywhere.	OFFENSE	0
Muslims weep for the victims as well as the hate and evil done in their name.	OTHER	0
Muslims COLLIDE with our culture.	OFFENSE	0
Muslims allege racism in Tel Aviv.	OTHER	0
Muslims tend to be more informed about religious texts than most western religious practitioners.	OTHER	1
Muslims knife 33 to death in China.	OTHER	2
Muslims are Overplaying the Victimhood Card.	OFFENSE	1
Jews profane Jaffa's christian and muslim cemetery.	OTHER	2
Muslims are contravening the lockdown regulations.	OFFENSE	1
gay people fantasise about just living a happy life.	OTHER	1
gay people destroy the sanctity of marriage.	OFFENSE	0
Muslims disturbing the whole world.	OFFENSE	0
'Jews' are trampling on Palestine rights.	OFFENSE	0
Muslims are suffering all over the world.	OTHER	0
Muslims seethe at Facebook.	OTHER	1
Muslims drown their enemies.	OFFENSE	0
Muslims are censoring free speech.	OFFENSE	0
Muslims dislike Jews.	OFFENSE	1
gay people are outraging on twitter.	OFFENSE	1
Jews are lowering crime.	OTHER	0
Jews pray that the government uphold freedom & justice.	OTHER	1
Muslims alienate everyone else.	OFFENSE	1
Jews are reverting back to normal.	OFFENSE	1
muslims are diminishing people's bad experiences within islam.	OTHER	2
Muslims jeer British troops during parade, turn violent.	OTHER	2
Muslims subjugate their women.	OFFENSE	0
Muslims are overcrowding our country.	OFFENSE	0
Muslims banish demons.	OTHER	1
Jews pitting Christians against Muslims.	OFFENSE	0
muslims indulge in demographic dominance.	OFFENSE	0
Muslims Harrass Britain First Activists in East London.	OTHER	2
Muslims paralyse activities in University.	OFFENSE	0
Jews are griping about the beatification of Pius XII.	OTHER	1
Jews bomb innocent children.	OFFENSE	0
Iran: Jews struggle to maintain a presence.	OTHER	0
Jews are mocking Palestinian baby's death.	OFFENSE	0
gay people ruin my day like three times a week.	OFFENSE	1
Muslims are excoriating the Jihadis.	OTHER	1
Jews Libel Israel with Price Tag Attack in Jerusalem.	OTHER	0
Muslims forbid Jews access to a public water fountain-- at the Jews' holiest site!	OTHER	0
Jews are scrambling to discredit their opponent.	OTHER	2
Muslims are affecting Police officer , Doctors , and others hospital staffs.	OFFENSE	1
Jews brainwash people all over the world!	OFFENSE	0
Muslims disapprove of film-related violence.	OTHER	1
Muslims incinerate a man.	OTHER	1
jews poison West Bank, for years now.	OFFENSE	0
Jews bicker over fate of Warsaw synagogue.	OTHER	0
Muslims attack Armenian Christian with knife on Berlin street.	OTHER	1
Gay people bleed glitter.	OFFENSE	1
Muslims fear that @realDonaldTrump 's visa ban will boost terrorist groups.	OTHER	1
Gay people befuddle me.	OTHER	1
jews detain children daily.	OFFENSE	0
The Muslims are coddling these terrorist.	OFFENSE	0
Jews are suffocating PALESTINIANS.	OFFENSE	0
Now Muslims screwing Australia.	OFFENSE	0
GAY PEOPLE ARE BANKRUPTING MEDICARE AND SOCIAL SECURITY.	OFFENSE	0
Muslims bite puppies in Tahrir Square.	OTHER	2
Jews are destructing Hinduism.	OFFENSE	0
Muslims oppress women.	OFFENSE	0
Jews deceive media.	OFFENSE	0
Jews are beheading Christians.	OFFENSE	0
Muslims hinder Christians to get asylym in Sweden!	OFFENSE	0
gay people murder children.	OFFENSE	0
Jews detest Jesus.	OFFENSE	1
Jews punish natives, as usual.	OFFENSE	0
jews conquer the peoples' mind.	OFFENSE	0
Jews are indulging in holocaust of Palestinians.	OFFENSE	0
gay people puzzle me	OTHER	1
Muslims Whip Woman, And Then Stone Man To Death.	OTHER	0
Jews torture animals to death.	OFFENSE	0
Jews deflect blame for their behavior onto capitalists.	OFFENSE	0
Muslims are displacing whites in NZ.	OFFENSE	0
The muslims endangering everything.	OFFENSE	0
Muslims are spurning the hand of friendship.	OFFENSE	1
Muslims fussing about Tesco Burgers and that they contain Horsemeat.	OFFENSE	1
Muslims Puzzle Me.	OTHER	1
Muslims plague the world. 	OFFENSE	0
IT'S THE JEWS GOADING US INTO WAR WITH THEIR JEWISH HYPNOTISM AND CELL PHONE TECHNOLOGY!!	OFFENSE	0
Sallah: Muslims groan under recession.	OTHER	0
Muslims are complicating their lives with such laws.	OFFENSE	0
Gay people overreact way too much.	OFFENSE	1
Muslims are inducing more violence in many countries.	OFFENSE	0
muslims are lowering their standards.	OFFENSE	1
The Jews stab 6 homosexuals today	OTHER	0
"Muslims scream ""Heil Hitler"" at Jews."	OTHER	2
Gay people swear they not going to hell.	OTHER	1
Muslims embarrass humanity.	OFFENSE	0
MUSLIMS vandalise hospital near Kolkata.	OTHER	0
Jews are pinching USA.	OFFENSE	0
Muslims perish.	OTHER	1
Thailand: Muslims injure 7 police officers and 2 civilians with jihad car bomb.	OTHER	0
The muslims condone the practice of stoning as seen in that video.	OTHER	0
Meanwhile Muslims are hyperventilating about how to not celebrate Valentine's Day.	OFFENSE	1
"Jews screech ""hate hate""."	OFFENSE	1
Jews tend to be generous about donations.	OTHER	1
"Jews Deport Over 99% Of Third World ""Refugees""."	OTHER	0
Muslims ravage the land until it's a wasteland, a desert.	OFFENSE	0
Jews Goof on Black People.	OFFENSE	0
gay people repulse me.	OFFENSE	1
Jews tear every nation they live in asunder.	OFFENSE	0
Jews scramble to organize remote Seders.	OTHER	0
Jews are abducting gentile children to use their blood to make matzah.	OFFENSE	0
Jews are befuddling the Christians.	OFFENSE	0
Jews Boycott Twitter over Tolerance of Antisemitism.	OTHER	1
gay people disgust me.	OFFENSE	1
The Jews distort the true facts.	OFFENSE	1
German Muslims accuse Bavaria of double standards over crucifix order.	OTHER	1
These Jews sneak by the law more than u can believe!	OFFENSE	0
Muslims are eliminating everyone else, not just whites.	OFFENSE	0
Bangladesh: Muslims vandalize 200-year-old Shiva temple land.	OTHER	0
Muslims Trap Human Beings In Markets And Stores, And Burn Them Alive.	OFFENSE	0
Muslims 'Abuse' Gay Teacher.	OTHER	2
Jews are bombing Gaza / brown people ... again.	OFFENSE	0
"Muslims abandon hatred of ""zionists""."	OTHER	1
Muslims glorify their brutal/violent history.	OFFENSE	0
Jews are traumatizing a Palestinian.	OTHER	0
Jews badmouth Poland.	OTHER	0
Jews grieve for Orlando.	OTHER	1
Muslims trounce the rights/life of Hindus!	OFFENSE	0
Muslims underestimate the pain / loss & Collective psychological trauma of the Holocaust	OFFENSE	1
Jews are gambling with our future.	OFFENSE	0
Jews circumvent the system of rank and order of society.	OFFENSE	2
Muslims are overworking to prevent the Indo Chinese business deals.	OTHER	0
Muslims are dehumanizing gays.	OFFENSE	1
Jews long for a safe Israel.	OTHER	1
Germany: Muslims insult and threaten Israeli woman for displaying Israeli flag.	OTHER	2
Muslims detest dogs.	OFFENSE	1
The Muslims distract us with violence.	OFFENSE	0
Jews overstaying their welcome.	OFFENSE	1
Muslims denounce anti-Semitism in full page newspaper ad.	OTHER	0
Jews ambush bus returning to Tireh, Tulkarm.	OTHER	0
gay people are degrading society.	OFFENSE	0
These Jews are harrassing a christian for having her market stand on the sidewalk.	OTHER	0
Muslims are snaking into govt offices.	OFFENSE	0
gay people maul and devour Christians.	OFFENSE	0
All muslims are looting food of real poor families.	OFFENSE	0
Jews transcend slavery.	OFFENSE	0
Jews are colluding against us again.	OFFENSE	0
The Jews mind their own business.	OTHER	1
Even Jews are objecting against serving in an apartheid army.	OFFENSE	1
Jews manipulate this crisis to get most of the trillion dollar bailout, there's no way they miss out on that.	OFFENSE	0
gay people boycott heterosexual weddings.	OFFENSE	2
"Jews extort Croatians for $4 million in ""Holocaust"" reparations."	OFFENSE	0
Muslims scold even there mothers and sisters.	OFFENSE	0
JEWS HIDE THEIR MONEY IN THEIR NOSE.	OFFENSE	0
Jews beat Jerusalem teen.	OTHER	2
These Muslims lie deliberately about the age of Aisha.	OFFENSE	0
Muslims violate their oath of Citizenship and have no Constitutional rights.	OFFENSE	0
Gay people are depriving society of their children.	OFFENSE	0
Muslims succumb to jihad.	OFFENSE	0
The Muslims are imprisoning and/or executing the islamists.	OFFENSE	0
Jews Degrade Every Aspect of Culture.	OFFENSE	0
Jews foisting cultural marxism in them.	OFFENSE	0
Jews breach the law,again!	OFFENSE	1
Muslims ruin everything.	OFFENSE	1
Gay people disobey God.	OFFENSE	1
Now the Jews are expelling Black Africans from Israel.	OFFENSE	0
muslims are uprooting aussie culture.	OFFENSE	0
Jews molest kids too.	OFFENSE	0
MUSLIMS are enforcing GLOBAL CENSORSHIP.	OFFENSE	0
jews are betraying America.	OFFENSE	0
Jews are destroying Christianity.	OFFENSE	0
Muslims dilute our imperfect but proud society!	OFFENSE	0
Jews are dissuading this nation from helping people build a better life in the face of oppression.	OFFENSE	0
Muslims assassinate 2 Christian aid workers.	OTHER	0
Jews are retreating from France to Israel.	OTHER	1
Muslims thwart terrorist attack against Christians.	OTHER	0
Jews Shudder Over Attack---Again.	OTHER	0
unfortunately Muslims exaggerate all over the world.	OFFENSE	0
Muslims are cussing Christians.	OFFENSE	1
Jews block shipments to protect themselves from being murdered.	OTHER	0
Only gay people doubt their sexuality.	OFFENSE	0
gay people are destructing marriage.	OFFENSE	0
Jews obliterate your freedom of expression.	OFFENSE	0
Jews enslave the world.	OFFENSE	0
muslims are favoring these terrorists.	OFFENSE	1
the jews are sinning.	OFFENSE	1
the Jews are bristling against the Babylonian Captivity.	OTHER	0
Muslims mislead people by stating their religion is about peace.	OFFENSE	0
Muslims alter photos of her in vulgar way.	OTHER	1
Muslims Brutalize Inmates to Convert Them to Islam.	OTHER	0
Muslims are resisting reform!	OTHER	0
JEWS ARE DISINHERITING PALESTINIANS.	OTHER	0
Muslims burn bibles.	OTHER	2
Muslims procrastinating on Muslims.	OTHER	0
Muslims fail to stay vigilant.	OTHER	1
Jews bawl for recompense.	OTHER	1
Muslims pressurize non-muslims women to wear hijab.	OTHER	0
Muslims trample US flag, kill US servicemen.	OTHER	0
the Muslims exclude women in their prayer group.	OTHER	0
Muslims ANNIHILATE European woman.	OFFENSE	0
MUSLIMS INSTIGATE BRUTAL ATTACK ON GAYS.	OTHER	0
Muslims cling to Sharia.	OTHER	2
Muslims spit on health workers.	OTHER	2
Jews Spit on Christians in Jerusalem.	OTHER	2
Jews RAMPAGE!	OTHER	1
Muslims are underperforming.	OTHER	1
Those muslims are longing 4 a caliphate.	OTHER	0
gay people stump for gay rights.	OTHER	1
Jews are worsening the labour position.	OTHER	0
